16
11
######## ######
#.#@...###....#
#v##.oo....o..#
#v##..oo#.o.o.#
#v##....#.....#
#v#######H#####
#v#    #......#
#v######......#
#..vvvvoooo...#
#..#####......#
####   ########
