14
12
######  #####
#....#  #...#
#.o..####.o.#
#.o......o..#
#..###@###o.#
##########.###
#..vvv<#.....#
#..#####o....#
##v#   #.o...#
 #v#####.o...#
 #..vvvvo.o..#
 #..##########
 ####
